7 7 -1 -10 1000 0.999 1e-6
#######
#DDDDD#
#D#####
#D#D#D#
#D#DDD#
#DDD#G#
#######
