15 15 -1 -10 1000 0.999 1e-6
###############
#             #
############# #
#             #
# #############
#             #
#DDDDDDDDDDDD #
#             #
# DDDDDDDDDDDD#
#             #
#DDDDDDDDD    #
#             #
#          ##D#
#          DDG#
###############
